NO map/textures/labyrinthe/north.xpm
EA map/textures/labyrinthe/est.xpm
WE map/textures/labyrinthe/west.xpm
SO map/textures/labyrinthe/west.xpm

111111111111111111111111111111
100000000000000000000000000001
100000000000000000000000000001
10000000000000N000000000000011
111111111111111111111111111111

F 220,100,0
C 225,30,0