NO map/textures/labyrinthe/north.xpm
EA map/textures/labyrinthe/est.xpm
WE map/textures/labyrinthe/west.xpm
SO map/textures/labyrinthe/west.xpm

F 220,100,0
C 225,30,0

        111 1111111 11111111111
        10000000001 10000000001
        10110000011 10000000001
        10010000000110000000001
1111111110110000011100000000001
1000000000110000011101111111111
1111011111111101110000001000111
11110111111111011101010010001
11000000110101011100000010001
10000000000000001100000010001
10000000000000001101010010001
1100000111010101111111110N0111110111
11110111 1110101 101111010001
11111111 1111111 111111111111
