NO map/textures/labyrinthe/north.xpm
EA map/textures/labyrinthe/est.xpm
WE map/textures/labyrinthe/west.xpm
SO map/textures/labyrinthe/west.xpm

F 220,100,0
C 225,30,0

111111111111
111110001001
100000011001   11011
111000000001   11001
10S000000001   10001
111111000001   11111
110000000001
111111111111