C 0,0,0
F 0,0,0
11111111111111
10000000000001
10000000000001
100000000S0001
10000000000001
10000000000001
11111111111111
NO map/textures/nympheas/Nympheas1.xpm
SO map/textures/nympheas/Nympheas2.xpm
WE map/textures/nympheas/Nympheas3.xpm
EA map/textures/nympheas/Nympheas4.xpm