NO map/textures/Mario/luigi.xpm
SO map/textures/Mario/mario.xpm
WE map/textures/Mario/yoshi-geant.xpm
EA map/textures/Mario/bowser.xpm

C 0,255,0
F 0,255,0

1111111111111111111111111111111111111111111111111111111
1000000000000000000000000000000000000000000000000000001
100000000000000000000000000000000000000000000000000001
100000000000000000000N000000000000000000000000000000001
1000000000000000000000000000000000000000001111111111111
1000000000000000000000000000000000000000000000000000001
1000000000000000000000000000000000000000000000000000001
1000000000000000000000000000000000000000000000000000001
100000000000000000000000000000000000000001111111111111
1000000000000000000000000000000000000000000000000000001
1000000000000000000000000000000000000000000000000000001
1000000000000000000000000000000000000000000000000000001
1000000000000000000000000000000000000000001111111111111
1000000000000000000000000000000000000000000000000000001
1000000000000000000000000000000000000000000000000000001
1000000000000000000000000000000000000000000000000000001
1000000000000000000000000000000000000000001111111111111
1000000000000000000000000000000000000000000000000000001
1000000000000000000000000000000000000000000000000000001
1000000000000000000000000000000000000000000000000000001
1000000000000000000000000000000000000000001111111111111
100000000000000000000000000000000000000000000000000001
1000000000000000000000000000000000000000000000000000001
1000000000000000000000000000000000000000000000000000001
1000000000000000000000000000000000000000001111111111111
1000000000000000000000000000000000000000000000000000001
1000000000000000000000000000000000000000000000000000001
1000000000000000000000000000000000000000000000000000001
1000000000000000000000000000000000000000001111111111111
1000000000000000000000000000000000000000000000000000001
1000000000000000000000000000000000000000000000000000001
1000000000000000000000000000000000000000000000000000001
1000000000000000000000000000000000000000001111111111111
1000000000000000000000000000000000000000000000000000001
1000000000000000000000000000000000000000000000000000001
1000000000000000000000000000000000000000000000000000001
1000000000000000000000000000000000000000001111111111111
1000000000000000000000000000000000000000000000000000001
1000000000000000011111111111111111111111111111111111111
1111111111111111111111111111111111111111111111111111111