NO map/textures/bubble_gum/north.xpm
SO map/textures/bubble_gum/south.xpm
WE map/textures/bubble_gum/west.xpm
EA map/textures/bubble_gum/east.xpm

F 255,51,153
C 255,204,255

        1111111111111111111111111
        1000000000110000000000001
        1011000001110000000000001
        1001000000000000000000001
111111111011000001110000000000001
100000000011000001110111111111111
11110111111111011100000010001
11110111111111011101010010001
11000000110101011100000010001
10000000000000000000000010001
10000000000000000001010000001
1100000111010101111111110N0111
11110111 1110101 101111010001
11111111 1111111 111111111111
