C 51,0,51
F 160,160,160

NO map/textures/labyrinthe/north.xpm
SO map/textures/labyrinthe/south.xpm
EA map/textures/labyrinthe/est.xpm
WE map/textures/labyrinthe/west.xpm

1111111111111111111111111
1000000000000000000000001
1011111111111111111100N01
1000000000000000000100001
1111110111111111100111111
1000000100000000100000001
1011110101111110101111101
1010000101000010101000101
1010111101011010101110101
1010000001001010101000101
1111111111001010111111111
1000000000000010000000001
1011111111111111111111101
1000000000000000000000001
1111111111111111111111111
